155,155,155,155,155,59,60,154,155,155,155,155,155,155,154,154,154,154,155,155
155,155,155,154,154,91,92,154,154,155,155,155,155,155,154,27,28,154,155,155
155,155,154,154,20,21,22,23,154,154,155,155,155,155,154,59,60,154,155,155
155,154,154,18,52,53,54,55,82,154,154,155,155,154,154,91,92,154,154,155
155,154,51,52,117,374,374,87,55,56,154,155,154,154,20,21,22,23,154,154
155,154,83,84,85,374,374,85,87,88,154,154,154,18,52,53,54,55,82,154
155,154,115,181,561,435,436,561,85,120,154,154,51,52,117,85,85,87,55,56
155,154,147,278,561,467,468,561,85,152,154,154,83,84,279,85,85,85,87,88
155,154,179,148,561,561,561,561,85,389,358,358,390,148,561,435,436,561,279,120
155,154,211,532,500,561,561,501,502,216,154,154,147,148,561,467,468,561,245,152
155,154,243,496,497,561,561,497,497,248,154,154,179,148,561,561,561,561,277,184
155,154,275,342,561,119,119,561,279,280,154,154,211,532,500,561,561,501,502,216
155,154,307,470,470,151,151,470,470,312,154,154,243,496,497,561,561,497,497,248
155,154,185,592,592,183,183,592,592,190,154,154,275,308,561,435,436,561,279,280
155,154,217,313,314,315,316,317,318,222,154,154,307,470,470,467,468,470,470,312
155,154,154,345,346,347,348,349,350,154,154,154,185,405,405,405,405,375,592,190
155,154,154,377,378,379,380,381,382,154,154,154,217,313,314,315,316,317,318,222
155,154,154,154,410,411,412,413,154,154,154,154,154,345,346,347,348,349,350,154
155,155,155,155,155,155,155,155,155,155,154,154,154,377,378,379,380,381,382,154
155,155,155,155,155,155,155,155,155,155,155,154,154,154,410,411,412,413,154,154
